8
********
*S     *
* **** *
*    E *
**** * *
*    * *
* **** *
*     F*