12
************
*S         *
* ****T*** *
* **** * * *
* **** * * *
*   ** * *T*
* * **   * *
* * **** * *
* *      * *
* ******** *
*        EF*
************