10
**********
*S       *
* ****** *
* *    * *
* * ** * *
*  T     *
* * ** * *
* *    * *
* ****** *
*      EF*