14
**************
*S           *
* ***** **** *
* *        * *
* * *** ** *T*
* * *    * * *
* *T* ** * * *
* * * ** * * *
* * *     T* *
* * ****** * *
* *       E* *
* ***** **** *
*          EF*
**************